0,3,3,3,1,1,1,0
3,0,0,0,0,0,1,0
0,3,0,0,0,0,1,0
3,2,4,5,2,4,1,0
0,4,5,2,4,5,2,0
0,0,0,0,0,0,0,0
0,0,0,0,0,0,0,0
0,0,0,0,0,0,0,0
0,0,0,0,0,0,0,0
0,0,0,0,0,0,0,0
0,0,0,0,0,0,0,0