1,1,3,3,2,2,4,4
1,1,3,3,2,2,4,0
2,2,4,4,1,1,3,3
2,4,4,1,1,3,3,0
0,0,0,0,0,0,0,0
0,0,0,0,0,0,0,0
0,0,0,0,0,0,0,0
0,0,0,0,0,0,0,0
0,0,0,0,0,0,0,0
0,0,0,0,0,0,0,0
0,0,0,0,0,0,0,0